E, Mićo, stvarno si glup... Sada je tačno... ..jako kasno. Moramo da požurimo.	Ne znam.
Ne znam.	Pa gde si dosad, čoveče, znaš koliko je sati?
Nego naš. To jest, Hrvat... pa to, naš...  Mislim, pričao je srpski. To jest, hrvatski... Ma, taj naš, što god, važno je da sam ga razumeo. Vidi, on mi je prodao, sa popustom, u stvari, nije mi ni uzeo kintu...	Nego šta?
Nego šta?	Ne, ne, nije Čeh...
Ne, ne, nije Čeh...	Nego?
Nego?	A ne Kićo, nije on bio Čeh!
A ne Kićo, nije on bio Čeh!	Znam da ne znaš. Trebalo ti je dve godine da naučiš „ahoj, hau ma“, a   sad mi javljaš kako sa češkim šumarima diskutuješ o estetici...
Znam da ne znaš. Trebalo ti je dve godine da naučiš „ahoj, hau ma“, a   sad mi javljaš kako sa češkim šumarima diskutuješ o estetici...	Ne znam.
Ne znam.	Bilo koja.
Bilo koja.	Aha. Unutarnja ili unutrašnja?
Aha. Unutarnja ili unutrašnja?	Dekoracija, Mićo.
Dekoracija, Mićo.	Čekaj, šta si tačno mislio da ti kažem?
Čekaj, šta si tačno mislio da ti kažem?	Mislim, na češkom. Kako se na češkom to kaze?
Mislim, na češkom. Kako se na češkom to kaze?	Kako to misliš?
Kako to misliš?	E, a molim te, ponovi mi kako ti je rekao...
E, a molim te, ponovi mi kako ti je rekao...	Unutarnja ili unutrašnja, ne sećam se sad...
Unutarnja ili unutrašnja, ne sećam se sad...	Baš „unutarnja dekoracija“?
Baš „unutarnja dekoracija“?	Baš tako.
Baš tako.	Tako ti je rekao?
Tako ti je rekao?	Nije, Kićo, prodavac mi je rekao: „Pane, kod nas u Češkoj, to vam je unutarnja dekoracija!“
Nije, Kićo, prodavac mi je rekao: „Pane, kod nas u Češkoj, to vam je unutarnja dekoracija!“	Naravno da je na sniženju, kad su to grane za groblje. Ko je još video dase unose u kuću?
Naravno da je na sniženju, kad su to grane za groblje. Ko je još video dase unose u kuću?	Da okitimo malo, ipak je Nova godina. A i kupio sam na snizenju.
Da okitimo malo, ipak je Nova godina. A i kupio sam na snizenju.	Neće oni mene više zajebavati s tim kazaljkamal! 'Ajde, oblači se, nemamo puno vremena... Šta radiš to?
Neću.	Jao, evo ga on opet.  'Oćeš još jedan šamar?
Pa 'de si sad našo da misliš? Nemamo puno vremena, treba da proba–   mo tačku!	Ništa, nešto mislim na mamu...
Ništa, nešto mislim na mamu...	Šta kažeš?
Šta kažeš?	Kako me uvek provali, mamu mu...?
Kako me uvek provali, mamu mu...?	Ajde, obuci se.
Ajde, obuci se.	Znam. Izvini ti.
Znam. Izvini ti.	Izvini. Znaš da sam osetljiv na mamu.
Izvini. Znaš da sam osetljiv na mamu.	Ma jok.
Ma jok.	Je l' te boli?
Je l' te boli?	Neću.
Neću.	Eto vidiš. A mene tu vataš na emocije, bratstvo i jedinstvo, te šeme... Aj-   de, dobro, nema veze. Samo nemoj da me lažeš.
Eto vidiš. A mene tu vataš na emocije, bratstvo i jedinstvo, te šeme... Aj-   de, dobro, nema veze. Samo nemoj da me lažeš.	Kupio sam grane na pijaci od Čeha, platio sam punu cenu i mislim da   me zajebao za kusur.
Kupio sam grane na pijaci od Čeha, platio sam punu cenu i mislim da   me zajebao za kusur.	Ne kuni se u majku, barabo jedna!
Ne kuni se u majku, barabo jedna!	Ma, ne, Kićo, majke mi...
Ma, ne, Kićo, majke mi...	Ne seri.
Ne seri.	Molim?
Molim?	E, Mićo...
Eto vidiš da ga i ti poznaješ! I što me onda šamaraš za džabe!!!	Onaj Hrvat?
Onaj Hrvat?	Onaj sa granama.
Onaj sa granama.	Ma, ko ti je to rekao!?
Ma, ko ti je to rekao!?	Svako je odgovoran za sebe i sopstvenu sudbinu.
Svako je odgovoran za sebe i sopstvenu sudbinu.	Ti, Mićo. Ti... Čekaj, kako bre ti?
Ja, Mićo. Ja. I ko je obećao mami da će voditi računa o tebi, da ne upadneš u neko sranje i da te ne prevari neka, ko?	Ti, Kićo.
Ti, Kićo.	Kako – „ko“? Pa, ko te je, čoveče, spakovao čim su prvi put došli da tezovu i ko je preko noći našao šemu za Prag? Ko?
Kako – „ko“? Pa, ko te je, čoveče, spakovao čim su prvi put došli da tezovu i ko je preko noći našao šemu za Prag? Ko?	Ko, Mićo?
Ko, Mićo?	Pa ko te je onda doveo?
Pa ko te je onda doveo?	Tako je, Kićo.
Tako je, Kićo.	Nije, Mićo, vojska te je oterala od kuće, al' te nije dovela ovde. Je l' tako?
Nije, Mićo, vojska te je oterala od kuće, al' te nije dovela ovde. Je l' tako?	Vojska.
Vojska.	'Ajde, Mićo, reci ti meni, ko te je doveo ovde?
Aha, evo odmah!	Pa gde si sad našao da mislišl? Nemamo puno vremena, treba da probamo tačku!
Pa gde si sad našao da mislišl? Nemamo puno vremena, treba da probamo tačku!	Ništa, nešto mislim...
Ništa, nešto mislim...	Sta kažeš?
Sta kažeš?	Kako me uvek zajebe, mamu mu...!?
Kako me uvek zajebe, mamu mu...!?	Ajde, obuci se.
Molim, Kićo.	E, Mićo...
E, pa slušaj, ako ti imaš nešto bolje, ti idi! Idi, slobodno... Idi, šta čekaš! Tako je, idi!	Ovaj jeste.
To se i ja pitam, Kićo. Ima li sve ovo smisla?	Mene si naš'o da radiš, je li!? Pa je l' ima to smisla!?
Evo ga opet! Ja ti bre nudim život na estradi, šou-biznis međunarodnihrazmera, budućnost kakvu bi svaki momak iz „Cvetića“ mogao samo da poželi– lova, ribe, malo rada, a ti mi tu pričaš o ribi sa Zvezdare! Pa gde to ima?!?	Ja sam svoje davno izabrao. Moj izbor je u Gročanskoj 44.
Ja sam svoje davno izabrao. Moj izbor je u Gročanskoj 44.	Nije istina! Padaju od želje! One se nama dive, žele da nas poseduju, a našeje samo da biramo. Ako hoćemo – hoćemo, ako nećemo, ne moramo, razumeš?!
Nije istina! Padaju od želje! One se nama dive, žele da nas poseduju, a našeje samo da biramo. Ako hoćemo – hoćemo, ako nećemo, ne moramo, razumeš?!	Padaju od alkohola.
Padaju od alkohola.	Ne, jako bih voleo da meni neko to obezbedi, laka lova, četiri sata rada,i to noću, u disko klubu. Igraš malo, malo piješ piće, ribe samo padaju...
A, pa ne, nisam ja nigde krenuo. Ja sam mislio da me ti negde konkretno Šalješ...	Pa gde si krenuo?
Znam, Kićo. To mi svi kažu.	Mnogo si glup.
Mnogo si glup.	Molim, Kićo.
Molim, Kićo.	Mićo...
Ma nemoj, daj da vidim!	Imam ja para. Uštedeo sam.
Imam ja para. Uštedeo sam.	Beograd ne možeš da zoveš. Nemamo love.
Beograd ne možeš da zoveš. Nemamo love.	Sta te briga, daj mi ga!!!
Sta te briga, daj mi ga!!!	Koga ćeš da zoveš?
Koga ćeš da zoveš?	Ma, baš me briga šta ti misliš. Daj mi telefon.
Ma, baš me briga šta ti misliš. Daj mi telefon.	To ti je isto.
To ti je isto.	To je zato što sam emotivan.
To je zato što sam emotivan.	To je zato što si glup.
To je zato što si glup.	Ma kakvu tajnu, bre. Nemam ja tajnu. Ja volim Anu.
Ma kakvu tajnu, bre. Nemam ja tajnu. Ja volim Anu.	Neće njoj mama ništa reći. Ona zna da čuva tajnu.
Neće njoj mama ništa reći. Ona zna da čuva tajnu.	A šta ti lupaš, kakve ribe, kad se javi Ana, mama može da joj kaže...
A šta ti lupaš, kakve ribe, kad se javi Ana, mama može da joj kaže...	Šta se dereš, budalo jedna. Hoćeš da se mama sekira.
Imam, kad mi vratiš! Čuješ! Nećeš ti meni odredivati na šta ću ja da trošim svoje pare!	A ti ima’?
A ti ima’?	Nema para.
Nema para.	Što ona tebe ne zove!
Što ona tebe ne zove!	Pusti me, čoveče, nisam je čuo tri meseca!
Pusti me, čoveče, nisam je čuo tri meseca!	...l to je lepo sa tvoje strane, znaš u kakvim smo dugovima.
...l to je lepo sa tvoje strane, znaš u kakvim smo dugovima.	Daj mi te pare, to su moje pare, ja sam ih uštedeo...!
Daj mi te pare, to su moje pare, ja sam ih uštedeo...!	Odlično, baš nam toliko fali za kiriju!
Jedi govna.	Koliko je sati?
I to je tačno, ali za ovu teoriju nije bitno. Ono što ja pokušavam već dvegodine Jeste da ti objasnim da je ljubav na daljinu apsolutno nemoguća i ti konačno treba da se pomiriš sa tim!	Da je bila kurva.
Da je bila kurva.	Pa to. Volela me, ali ipak me šutnula. Odmah posle zakletve.
Pa to. Volela me, ali ipak me šutnula. Odmah posle zakletve.	Najjača. Pa šta.
Najjača. Pa šta.	Nema sad veze mama, ima veze želja, misao. To je bila jaka ljubav.
E, odlično što se odlično sećaš. Onda se seti i kakva je to ljubav bila. Hteosam i da je ženim.	Nije, nego od viskija. Otišla je cela flaša, odlično se sećam.
Nije, nego od viskija. Otišla je cela flaša, odlično se sećam.	A napila se od tuge.
A napila se od tuge.	Plakala je jer se napila.
Plakala je jer se napila.	Au, da... Svejedno, ja sam bio. U Valjevu, burazeru, nije čak ni daleko, aona moja, znaš kako je plakala kad sam odlazio.
Au, da... Svejedno, ja sam bio. U Valjevu, burazeru, nije čak ni daleko, aona moja, znaš kako je plakala kad sam odlazio.	Nisam. Pobegao sam. Zato sam ovde.
Nisam. Pobegao sam. Zato sam ovde.	Jesi bio u vOJSCI?
Ma kakve bre ljubavi, konju jedan. Ko je danas još čuo za tu ljubav... nadaljinu? Gde to ima? Ti ovde, ona tamo, gde tu ima ljubavi!	Mene je briga, Kićo! Mene! Ja nju volim i ona voli mene i ne znam štati imaš protiv naše ljubavi!
Mene je briga, Kićo! Mene! Ja nju volim i ona voli mene i ne znam štati imaš protiv naše ljubavi!	Kao prvo, nemoj da se dereš. Rekao sam ti da su ove pičke fine. A kaodrugo, baš mene briga za Anu...
Kao prvo, nemoj da se dereš. Rekao sam ti da su ove pičke fine. A kaodrugo, baš mene briga za Anu...	Znao sam, znao sam! Ti hoćeš da ja prevarim Anu!!!
Aha.	Nemoj ništa da se brineš, samo ćemo malo da popričamo sa njima, popijemo po piće, pa u klub.
Nemoj ništa da se brineš, samo ćemo malo da popričamo sa njima, popijemo po piće, pa u klub.	Čekaj, Kićo, stani! Kako to da ih zabavimo?
Čekaj, Kićo, stani! Kako to da ih zabavimo?	Moraćemo mi da ih zabavimo.
Moraćemo mi da ih zabavimo.	Nemam pojma.
Nemam pojma.	'Ajde? Pa šta ćemo sad?
Neke knjige.	Pa nema... Čekaj!!! A šta čemo mi s njima? Mislim, šta hoće?
Pa nema... Čekaj!!! A šta čemo mi s njima? Mislim, šta hoće?	Šta tebe to briga! Pusti me da ih uvedem, nema smisla da stoje u hodniku.
Šta tebe to briga! Pusti me da ih uvedem, nema smisla da stoje u hodniku.	Pa to i ja kažem. Mi smo bre Srbi, čoveče! Može da bude i opasno!!! Mislim, koja je to majka, koja ih je pustila kod nas!?
Pa to i ja kažem. Mi smo bre Srbi, čoveče! Može da bude i opasno!!! Mislim, koja je to majka, koja ih je pustila kod nas!?	Nismo mi Rusi.
Nismo mi Rusi.	Pa i nije. Ovde čak i nije žurka.
Pa i nije. Ovde čak i nije žurka.	Nije to isto.
Nije to isto.	Čekaj, bre, Kićo, pa i nije u redu! Pa, ne, reci sam, zamisli da, za novaka,neke naše ribe, u sred Beograda, od svih mesta, odu, na primer, kod dva Rusana žurku! Šta bi rek'o?!
Čekaj, bre, Kićo, pa i nije u redu! Pa, ne, reci sam, zamisli da, za novaka,neke naše ribe, u sred Beograda, od svih mesta, odu, na primer, kod dva Rusana žurku! Šta bi rek'o?!	Vrlo fine i zato prestani da se dereš. Mogu da pomisle da nešto nije u redu.
Vrlo fine i zato prestani da se dereš. Mogu da pomisle da nešto nije u redu.	Ako je ovde najbolje zezanje, kako li je tek kod drugih... Devojke? Jesirekao devojke?
Nemoj tako, Mićo. Nova godina je.	Sere’! Kakve goste, ko bi kod nas došao?
Sere’! Kakve goste, ko bi kod nas došao?	Molim te, Mićo, uozbilji se. Stvarno imamo goste.
Molim te, Mićo, uozbilji se. Stvarno imamo goste.	Goste?
Goste?	Ne laži, mislio si. Slušaj, imamo goste.
Jer ako me vara, ja sam gotov.	Ma sto posto... Mislim, sto posto je verna... Ana? Pa ona je divna devojka, ona te obožava. Gde bi ona... Ja sam onu priču ispričao onako, tek da prekratim vreme,potpuno bez veze, šta ti Je, Mićo?
Ma sto posto... Mislim, sto posto je verna... Ana? Pa ona je divna devojka, ona te obožava. Gde bi ona... Ja sam onu priču ispričao onako, tek da prekratim vreme,potpuno bez veze, šta ti Je, Mićo?	Slušaj, Kićo, je l' ti stvarno misliš da me Ana vara?
Slušaj, Kićo, je l' ti stvarno misliš da me Ana vara?	Momenat! 'Ajde, Mićo, molim te, nemoj da ispadnem kulov...
Hvala ti, Mićo, videćeš, nisu akrepi, onako, malo su ružnjikave...	Šta čekaš?
Izvini, Kićo. Stvarno nisam hteo.	To mi je hvala. Sram te bilo.
Šta si rekao?	Pa ja sam mislio da si ti razuman dečko, da smo se mi dogovorili. Pa nemogu da radim samo za telefon. Koliko smo se računa naplaćali, peglicu bismodosad kupili! Ma, sahrani se u peglici, budalo!
Insistiram.	Dobro, ali samo jer insistiraš.
Dobro, ali samo jer insistiraš.	Hajde, uvedi devojku, nema smisla da toliko čeka.
Sto? To je moj brat... brat...	Domu.
Domu.	Je I'? A kde?
Je I'? A kde?	Pošla.
Pošla.	Kde je... druga?
Odlično, ni ja.	Ne.
Ne.	A engleski? Anglički?
A engleski? Anglički?	Ne.
Ne.	Vi govorite srpski?
Vi govorite srpski?	Znam.
Znam.	Mića.
Sedi i ti.	Molim, Kićo?
Molim, Kićo?	Mićo...
Prosim?	Odlično. Ni nemamo.
Odlično. Ni nemamo.	Ne.
Ne.	Viski?
Znam, znam, kako ne. Je jana prodavaka? Je Petr dobri student? Je Helena b Praze? Je svetr na stole?	Mićo! Šta se praviš glup! Sram te bilo, devojka te gleda. Misliš da joj jeprijatno! Sigurno znaš Još nešto da kažeš!
Znam.	Boli.
Boli.	Ljubav? Boli?
Mislio sam... ništa. Ništa nisam mislio.	Sta si mislio?!
Sta si mislio?!	Mislio sam...
Mislio sam...	Koj’ ti kurac, šta se vataš!?
Koj’ ti kurac, šta se vataš!?	Nisam znao kako...
Mnogo. Alena, dolazi ovamo!	Ne znam.
Ne znam.	E, to ti je pametno. Ko je još video koristi od razmišljanja. A i nemamopuno vremena, Je l' znaš koliko je sati?!
A kod mene ne plače. Džoni, molim te, učini mami da se ne ubije, bašna Novu godinu!	Znaš da plače kad ga ja uzmem.
Znaš da plače kad ga ja uzmem.	Evo ga, doktor akušerskih nauka; ‘ajde, majke ti, što ga ti ne uzmeš, kadznaš bolje?!
Evo ga, doktor akušerskih nauka; ‘ajde, majke ti, što ga ti ne uzmeš, kadznaš bolje?!	Mislim da ga mnogo treseš. Možda zato plače.
Pomaklo se nije.	Nemam pojma, pre Jedno pola sata.
Nemam pojma, pre Jedno pola sata.	Kad si stavila meso?
Kad si stavila meso?	Koje meso? A meso, nisam! Ne mogu ja na sve da mislim, idi ti radi nešto!!!
Koje meso? A meso, nisam! Ne mogu ja na sve da mislim, idi ti radi nešto!!!	Jesi li izvadila meso iz rerne?
To samo tebi može da se desi. Jesam ti rekla da treba da kupiš bateriju! Džoni, molim te... ovo dete je nesnosno!!!	Nemam pojma. Stao je.
Nemam pojma. Stao je.	Nemoguće. Ćuti, Džoni, molim te. Ne mogu da te slušam više! Trebalobi da je već gotovo. Koliko je sati?
Nemoguće. Ćuti, Džoni, molim te. Ne mogu da te slušam više! Trebalobi da je već gotovo. Koliko je sati?	Slučajno sam, ručka je masna. A meso je potpuno živo.
Slučajno sam, ručka je masna. A meso je potpuno živo.	Izgleda da je zaspao. Pa šta radiš, čoveče, taman se smirio!!!
Kako, molim te, da se ne nerviram?! Udaviću ovo dete, časna reč!!!	Ništa. Zaboravio sam. Nije važno, Sanja, nemoj da se nerviraš.
Ništa. Zaboravio sam. Nije važno, Sanja, nemoj da se nerviraš.	Šta kažeš.
Šta kažeš.	Ima.
Ima.	Otkud ti znaš koliko vremena ima, kad ni sat nisi u stanju da popraviš! To Jednom Australijancu ne može da se dogodi. 'Ajde da smo u Beogradu, pada nema svoč radnje...
Otkud ti znaš koliko vremena ima, kad ni sat nisi u stanju da popraviš! To Jednom Australijancu ne može da se dogodi. 'Ajde da smo u Beogradu, pada nema svoč radnje...	Ima još vremena...
Ima još vremena...	Sad je kasno. Oni samo što nisu došli!!!
Sad je kasno. Oni samo što nisu došli!!!	Nema problem, nije ništa strašno. Evo uključio sam rernu, biće gotovoza čas.
Nema problem, nije ništa strašno. Evo uključio sam rernu, biće gotovoza čas.	A što ga nisi ti uključio?! I što, uostalom, ti ne pripremiš ovu večeru,ionako je tvoja ideja bila da kod nas organizujemo doček! Džoni, zaveži!!!
A što ga nisi ti uključio?! I što, uostalom, ti ne pripremiš ovu večeru,ionako je tvoja ideja bila da kod nas organizujemo doček! Džoni, zaveži!!!	Šta da uradim? ...a, pa da. Nisi ni uključila šporet.
Šta da uradim? ...a, pa da. Nisi ni uključila šporet.	Miloše, molim te, uradi nešto, Ja ne mogu ovo više da izdržim!!!
Da ideš ti malo u pičku materinu, znaš!	Cini ti se.
Cini ti se.	Je I' to gospodin ciničan, il se meni samo čini?
Je I' to gospodin ciničan, il se meni samo čini?	Ništa.
Ništa.	Pa šta onda. Moja majka je i prala i sušila pelene, pa šta meni fali?!
Pa šta onda. Moja majka je i prala i sušila pelene, pa šta meni fali?!	E, zamisli da si u Beogradu, pa da nemaš pampers. Morala bi da pereši da sušiš pelene.
E, zamisli da si u Beogradu, pa da nemaš pampers. Morala bi da pereši da sušiš pelene.	Zabole me!
Zabole me!	Mislim da je mokar...
Kaća? Odakle ti ta ideja, majke ti? U Beogradu se nikada nismo družile. Ma, nismo se podnosile!!!	Mislio sam da ti je Kaća drugarica.
Mislio sam da ti je Kaća drugarica.	Uostalom, to su tvoji gosti.
Uostalom, to su tvoji gosti.	Slučajno sam.
Slučajno sam.	Ko te jebe! Ne moraš toliko da treskaš tim tanjirima. Ako te mrzi, ja ću.
Ko te jebe! Ne moraš toliko da treskaš tim tanjirima. Ako te mrzi, ja ću.	Što si prosta.
Vidiš, nisam o tome do sad razmišljao. Fenomen kupanja pred Novu godinu. Želja za promenom, želja da se speru sve ružne stvari, nada u taj novi period koji dolazi...	To ti je zato što živiš na Banovom brdu. Mi u centru imamo bojlere.
To ti je zato što živiš na Banovom brdu. Mi u centru imamo bojlere.	Ajde, Sanjice, nemoj da si tako nervozna. Pa Nova godina je, naša prva hova godina u Sidneju, napolju je toplo, sunce sija, zamisli sad kako je u Beogradu. Hladni stanovi, kod mene sigurno nema hi tople vode. Znaš, uvek za novaka nestane tople vode. Svi bi da se bar tog dana operu, pa onda, valjda zbogpotrošnje, nema vode za sve.
Ajde, Sanjice, nemoj da si tako nervozna. Pa Nova godina je, naša prva hova godina u Sidneju, napolju je toplo, sunce sija, zamisli sad kako je u Beogradu. Hladni stanovi, kod mene sigurno nema hi tople vode. Znaš, uvek za novaka nestane tople vode. Svi bi da se bar tog dana operu, pa onda, valjda zbogpotrošnje, nema vode za sve.	Uopšte nije smešno.
Uopšte nije smešno.	A, ne, neću ga ja ni zvati. Rekao je da će se on javiti!
A, ne, neću ga ja ni zvati. Rekao je da će se on javiti!	Nije u redu!... I nije on za tebe ćale. On je moj otac. Neću da čujem daga zoveš ćale.
Nije u redu!... I nije on za tebe ćale. On je moj otac. Neću da čujem daga zoveš ćale.	Je I' sad u redu?
Je I' sad u redu?	Tako Je, on je sve platio!!!
Tako Je, on je sve platio!!!	Nisam. Tvoj ćale je sve platio.
Nisam. Tvoj ćale je sve platio.	I ko je dao lovu za prvo vreme, ko? Da nisi možda ti!?
I ko je dao lovu za prvo vreme, ko? Da nisi možda ti!?	Nije.
Nije.	Ja? A čiji tata je, molim te, platio karte dovde? Da nije možda tvoj?
Ja? A čiji tata je, molim te, platio karte dovde? Da nije možda tvoj?	A što ti nešto nisi ponudila?
Što vičeš, vidiš da si ga probudio...	NE ČUJEM!!!
NE ČUJEM!!!	Čuješ, čuješ!
Čuješ, čuješ!	Ne čujem te.
Ne čujem te.	Čuješ, odlično.
Čuješ, odlično.	Ne čujem te.
Ne čujem te.	...mambu, zmiju, močugu, šipku, ćevap, mikrofon, crevo...!!!
...mambu, zmiju, močugu, šipku, ćevap, mikrofon, crevo...!!!	Sanja, stvarno...
Sanja, stvarno...	...đoku, kitu, pajser možda...?
...đoku, kitu, pajser možda...?	Sanja, ja sam te zamolio...
Sanja, ja sam te zamolio...	Misliš, kurac?
Misliš, kurac?	Pa to.
Pa to.	Šta nemam?
Šta nemam?	Ti to i nemaš.
Ti to i nemaš.	Kako na čemu. Pa na kurcu.
Kako na čemu. Pa na kurcu.	To, osim što je vulgarno, nije ni logično. Na čemu bih ti ja visio?
To, osim što je vulgarno, nije ni logično. Na čemu bih ti ja visio?	Je li, majke ti, dok si to mislio, na mom si visio?!
Je li, majke ti, dok si to mislio, na mom si visio?!	Mislio sam da su se odnosi popravili.
Stižete tačno na vreme.	Jesmo poranili? Duletu je crko sat, pa nismo znali...
Ja se, u stvari, sa najbližima ljubim samo jednom...	Dobro došli... Jao, izvini, ja sam se izgleda odvikla od tog seljačkog običaja, ljubljenjetri puta...
Dobro došli... Jao, izvini, ja sam se izgleda odvikla od tog seljačkog običaja, ljubljenjetri puta...	Mada nije da je Miloš baš neki ekspert... ni njemu ne radi sat.
Dobro...	To mi je nekako najintimnije. Kako si, Dule?
Ja sam mislila da je simpatično, kao šatrovački: Nidža-Nindža...	Hvala, nije trebalo... i molim te, nemoj da ga zoveš Nindža. To mi je odvratno. Ime mu je Džoni.
Hvala, nije trebalo... i molim te, nemoj da ga zoveš Nindža. To mi je odvratno. Ime mu je Džoni.	Vidi, Nindžo. To ti je od tvoje tetka Kaće...
Jebi SE.	Nećemo sad o tome.
Nećemo sad o tome.	Al' nije ni Nindža!
Al' nije ni Nindža!	Ime mu je Nikola, a ne Džoni.
Šta imaš? Džoni...	Ima, kako da ne! Ko će s ledom, ko će bez leda...?
Ima, kako da ne! Ko će s ledom, ko će bez leda...?	Domaćine, je l' ima u ovoj kući nešto da se popije!
Nema više. Popila Sanja.	Jeste, ona užička...
Jeste, ona užička...	Kajsijevača?
Kajsijevača?	Je li, a gde ti je ono od prošli put?
Pa si zato izabrala onaj otrov. Alkohol, šezdeset procenata, baš dobro zadete!	Ne znam, Kaća, da li si primetila, ali ja sam majka maloletnog deteta,takozvane bebe, koju Još uvek dojim. I ne bih htela da se u mom mleku nađebilo kakva hemija, da ga od malih nogu navučem ha analgetike.
Ne znam, Kaća, da li si primetila, ali ja sam majka maloletnog deteta,takozvane bebe, koju Još uvek dojim. I ne bih htela da se u mom mleku nađebilo kakva hemija, da ga od malih nogu navučem ha analgetike.	Pobogu, Sanja, ova drzava je barem bogata pejn kilerima. Nema vremena kapitalizam za zubobolju, glavobolju, srdobolju... Samo siđeš u samišku ikupiš lek.
Pobogu, Sanja, ova drzava je barem bogata pejn kilerima. Nema vremena kapitalizam za zubobolju, glavobolju, srdobolju... Samo siđeš u samišku ikupiš lek.	Nisam popila, nego sam stavljala obloge. Boleo me zub.
Nisam popila, nego sam stavljala obloge. Boleo me zub.	Opa! Nisam znala da si i ti ljubiteljka tih ruralnih obeležja!
I ti, Dule, od kad si ti u tom seljačkom fazonu? U Beogradu si uvek pioviski, rakiju nisi hteo ni da omirišeš, a sad mi već danima kukaš za tom brljom!	Stvarno, Sanja, onakvu rakiju da rasipaš...
Živeli.	E, pa živeli.
Nije loše. Od Nove godine dobijam slobodnu svaku nedelju.	Pa Miloge, kako je u ofisu?
Plata ostaje ista. To mi, u stvari, dođe kao povišica. Umesto sedam, radim šest dana u nedelji, a dobijam istu kintu kao i pre.	Ma nemoj, a plata?
E, molim te, idi osnuj sindikat, žali se na kapitaliste, radi šta hoćeš, samo nemoj da me guéis. Kako je kod tebe, u Sopu?	Nedelju dana. Je l' ti misliš da je to dosta?
Nedelju dana. Je l' ti misliš da je to dosta?	Imao si odmor.
Imao si odmor.	Kako to misliš. Mrzi me da radi? Pa već godinu dana radim svaki dan,bez prestanka.
Kako to misliš. Mrzi me da radi? Pa već godinu dana radim svaki dan,bez prestanka.	Ne laži. Što ti ne bi ponudili? Nego tebe mrzi da radiš!
Ne laži. Što ti ne bi ponudili? Nego tebe mrzi da radiš!	Nisu mi to ponudili.
Molim te, Dule, ti si završio istoriju umetnosti i radiš u galeriji. Znači –galerista si. To se tako kaže. Pogledaj u rečnik!	Daj, Kaća, ne lupetaj! Kakav galerista... Sipaj mi još jedan.
Daj, Kaća, ne lupetaj! Kakav galerista... Sipaj mi još jedan.	Ti si galerista.
Ti si galerista.	A nego šta sam?
A nego šta sam?	Ima veze, Dule, ima veze! Ovako izgleda kao da si ti prodavac!
Ima veze, Dule, ima veze! Ovako izgleda kao da si ti prodavac!	Pa dobro, nema veze...
Pa dobro, nema veze...	Molim te, Sanja, nije to nikakva šop, to je prodajna galerija antikviteta!
Jedi govna.	Ne može.
Ne može.	Ma, hajde, molim te. Neće ništa da mu fali.
Ma, hajde, molim te. Neće ništa da mu fali.	Ti ne možeš. Zbog Nikole.
Ti ne možeš. Zbog Nikole.	Sipaj i meni.
Idem da ga stavim da legne.	U, što smo osetljivi.
U, što smo osetljivi.	Jedi i ti govna.
Jedi i ti govna.	Mogli bismo, u stvari, da kupimo dve infuzije, da ih priključimo oboje   na flašu i Duleta i malog, što da se muče, pa da budu cimeri u šok-sobi...
Jeste, znam ja. Čitao sam o tome.	To je ta postnatalna kriza.
"Nemoj tako. Čitam i „Australijan Loteri Vikli"""	Ti si čit'o! Gde si, majke ti, ti to čito. Od kako smo došli ovde, nisi uzeou ruke ništa što nema loptu na naslovnoj strani. A da, može i reket ili skija. Drugo te ništa ne zanima!!!
Nisam znao da to ima.	Časopis za sportsku prognozu. Sipaj mi još jedan.
Časopis za sportsku prognozu. Sipaj mi još jedan.	Šta ti je to?
Samo napred. Dule je tek kod prve flaše. Duga je noć.	Izvinite. Idem da vidim da li joj treba pomoć.
Ima! Ima! Oni su krivi! Oni su krivi što ja sedim ovde, umesto da samkod kuće, sa svojim društvom, svojim prijateljima, da radim posao, za koji samse školovala i da od svoje, sopstvene, zarađene love, mogu pristojno da živim!!! Tvoj otac i tvoja majka i milioni takvih, koji su u pauzama pečenja rakije naplacu i klanja prasića po kadama, glasali za one zlikovce, za lopove i kriminalce!!! Zbog njih ja nisam mogla da ostanem u svojoj zemlji, u svom gradu, zbogdođoša iz raznih Gurguzovaca i njihovih zemljaka odande, koji su mi odredili ivlast i život i sudbinu!!!	Kakve sad veze ima moja majka...?
Kakve sad veze ima moja majka...?	Tvoja majka mene nikad nije volela! Nikad!!!
Tvoja majka mene nikad nije volela! Nikad!!!	Kaća, molim te, ne znaš šta pričaš...
Kaća, molim te, ne znaš šta pričaš...	A otkud ti znaš kakve ona sise ima, je li? I zato te je majka zvala, da tito priča! Je l' im zato šaljemo pare, da nas izveštavaju o sisama Ane Simović!!!
A otkud ti znaš kakve ona sise ima, je li? I zato te je majka zvala, da tito priča! Je l' im zato šaljemo pare, da nas izveštavaju o sisama Ane Simović!!!	Pa nema ona neke sise.
Pa nema ona neke sise.	Znam ja te audicije! Obim grudi i broj telefona, to je jedino što se traži!!!
Znam ja te audicije! Obim grudi i broj telefona, to je jedino što se traži!!!	Čekaj, bre, Kaća, otkud ti znaš kako je devojka dobila posao. Možda jebila audicija.
Čekaj, bre, Kaća, otkud ti znaš kako je devojka dobila posao. Možda jebila audicija.	To sam išla da se odmorim. Od napornog rada, od knjige!!! A ona, mala, zavrtela dupetom levo-desno i tras: na televiziju!!!
To sam išla da se odmorim. Od napornog rada, od knjige!!! A ona, mala, zavrtela dupetom levo-desno i tras: na televiziju!!!	Istina Je. Išla si na Brezu.
Istina Je. Išla si na Brezu.	"Nisam! Jer nisam mogla da dođem na red od takvih!!! Ispite sam dava–la u roku u Junu i septembru, nisi mog'o da me vidiš u „Em Džiju"" i samo samjednom, jednom za četiri godine studiranja, otišla na Kop na skijanje! Je l' istina!?!"
"Nisam! Jer nisam mogla da dođem na red od takvih!!! Ispite sam dava–la u roku u Junu i septembru, nisi mog'o da me vidiš u „Em Džiju"" i samo samjednom, jednom za četiri godine studiranja, otišla na Kop na skijanje! Je l' istina!?!"	Čekaj, bre, Kaća, kako tvoje? Kakve to veze ima s tobom. Pa ti nisi nikadni radila na televiziji...
Čekaj, bre, Kaća, kako tvoje? Kakve to veze ima s tobom. Pa ti nisi nikadni radila na televiziji...	Ona mala, majku li joj njenu! Je l' vidiš kako je profititrala!? Je I’ vidiš!? Ne, pa ona je direktno moje mesto ukrala, razumeš! Moje!!!
Ona mala, majku li joj njenu! Je l' vidiš kako je profititrala!? Je I’ vidiš!? Ne, pa ona je direktno moje mesto ukrala, razumeš! Moje!!!	Pa, dobro, nemoj da besniš, Ja sam ti samo onako ispričao, kaže mama,ceo komšiluk je ponosan.
Pa, dobro, nemoj da besniš, Ja sam ti samo onako ispričao, kaže mama,ceo komšiluk je ponosan.	Geografiju studira! A ja sa diplomom žurnalistike mogu da se zaposlim   u Geokarti. Da crtam mape, je li?
Geografiju studira! A ja sa diplomom žurnalistike mogu da se zaposlim   u Geokarti. Da crtam mape, je li?	Studira geografiju.
Studira geografiju.	Eto ti. Pa ne, ako je ona stigla do televizije, onda stvarno...! Ta mala. Paona hije ništa ni završila!!!
Eto ti. Pa ne, ako je ona stigla do televizije, onda stvarno...! Ta mala. Paona hije ništa ni završila!!!	To za oko ne znam. Ali ona čita vesti ı vodi top listu.
To za oko ne znam. Ali ona čita vesti ı vodi top listu.	Ona mala?! Ona što frflja, što joj jedno oko beži malo u stranu!?!
Ona mala?! Ona što frflja, što joj jedno oko beži malo u stranu!?!	E, ona. Zaposlila se na teveu.
E, ona. Zaposlila se na teveu.	Ana Simović, nije iz moje zgrade, nego iz susedne, četr'esčetvorke,znam...
Ana Simović, nije iz moje zgrade, nego iz susedne, četr'esčetvorke,znam...	Moja. Kaze ona mala, iz tvoje zgrade, znaš ona Aha...
Moja. Kaze ona mala, iz tvoje zgrade, znaš ona Aha...	Nisi. Tvoja ili moja?
Nisi. Tvoja ili moja?	Zvala je keva Jutros. Jesam ti rekao?
Zvala je keva Jutros. Jesam ti rekao?	Družimo se, zato što smo ovde. U Beogradu im u kuću ne bih privirila!!! Seljaci...
Družimo se, zato što smo ovde. U Beogradu im u kuću ne bih privirila!!! Seljaci...	Ja sam mislio da će ti to biti prijatno. Ipak se sa njim družimo...
Ja sam mislio da će ti to biti prijatno. Ipak se sa njim družimo...	Ma nemoj, a čija je ideja bila da slavimo Novu godinu sa njima?
Ma nemoj, a čija je ideja bila da slavimo Novu godinu sa njima?	Niko te nije terao da dolaziš...
Niko te nije terao da dolaziš...	Molim te, malo se obuzdaj. Treba još bar pet sati da sedimo ovde.
Evo, odmah!!!	E, dođi molim te, ako te ne mrzi!
E, dođi molim te, ako te ne mrzi!	Evo ga ovaj opet... ... Je I' treba neka pomoć!!!?
Ja-ko do-brol!!	Kol'ko dobro?
Kol'ko dobro?	Dobro...
Dobro...	Pa, kako je, Miloše?
Pa, kako je, Miloše?	Znamo...
Znamo...	Je l' znamo...?
Je l' znamo...?	Znamo kako je Kaća, molim te...
Znamo kako je Kaća, molim te...	Sa onakvom guzicom i ja bih plakala! Ajde samo malo. Samo da vidimo kako je.
Sa onakvom guzicom i ja bih plakala! Ajde samo malo. Samo da vidimo kako je.	Kaća, molim te, pa tu ti je muž, a i Sanji nije dobro. Plakala je...
Kaća, molim te, pa tu ti je muž, a i Sanji nije dobro. Plakala je...	Imam. A posebno sad.
Imam. A posebno sad.	Ti izgleda stalno imaš temperaturu...
Ti izgleda stalno imaš temperaturu...	I ja sam imala temperaturu. Satrdej Najt Fiver. Znaš kako mrzim da samsubotom sama...
I ja sam imala temperaturu. Satrdej Najt Fiver. Znaš kako mrzim da samsubotom sama...	E, Kaća, nemoj molim te, mogu da uđu...
E, Kaća, nemoj molim te, mogu da uđu...	Čekala sam te...
Čekala sam te...	Temperatura.
Temperatura.	Šta mu je bilo?
Šta mu je bilo?	Nikoli nije bilo dobro.
Nikoli nije bilo dobro.	Zašto?
Zašto?	Sinoć... nisam mogao.
Sinoć... nisam mogao.	Sinoć posle posla. Bio je dogovor.
Sinoć posle posla. Bio je dogovor.	Kad?
Kad?	Zašto nisi došao sinoć?
Zašto nisi došao sinoć?	Ništa, moram da prokuvam vodu. Sad će se valjda smiriti.
Ništa, moram da prokuvam vodu. Sad će se valjda smiriti.	Šta je bilo?
Šta to tebe briga!!!	Kaća! Opet nisi svršila?
Kaća! Opet nisi svršila?	E, to sranje zadrži za svoju ženicu. Ona je dovoljno neurotična, da može i da upali.
E, to sranje zadrži za svoju ženicu. Ona je dovoljno neurotična, da može i da upali.	Molim te, Kaća, nemoj da psuješ. Ne stoji ti.
Molim te, Kaća, nemoj da psuješ. Ne stoji ti.	Šta si se usr'o? Idem u kupatilo.
Šta si se usr'o? Idem u kupatilo.	Jesi normalna?!?
Jesi normalna?!?	Da ispričam Sanji.
Da ispričam Sanji.	Gde ćeš?
Gde ćeš?	Ma nemoj, nisam primetila!
Pa i to što kažeš.	To je bilo drugo vreme.
To je bilo drugo vreme.	Pa kako, bre, čoveče, još se sećam kad si se na Kićinom ispraćaju ušibao tako da sam te vozio u urgentni centar. Ispirali ti stomak od pola litre votke.
Pa kako, bre, čoveče, još se sećam kad si se na Kićinom ispraćaju ušibao tako da sam te vozio u urgentni centar. Ispirali ti stomak od pola litre votke.	Jebi ga. Ja sam fenomen.
Tako.	Stvarno. Uopšte ne izgledaš pijan. Nisi mnogo popio? Mnogo si popio. Pa kako onda nisi pijan?
Stvarno. Uopšte ne izgledaš pijan. Nisi mnogo popio? Mnogo si popio. Pa kako onda nisi pijan?	Mnogo pijem, a ne napijam se.
Mnogo pijem, a ne napijam se.	Voda? A, voda, evo odmah...! Daj joj, molim te. Hoćeš još jedan viski? Mnogo piješ.
Voda? A, voda, evo odmah...! Daj joj, molim te. Hoćeš još jedan viski? Mnogo piješ.	Pita Sanja gde je ta voda.
A, da izvini. Ti si druga priča, to za tebe ne važi. Ti si sad porodičan čovek, žena, dete, sve po propisu...	Nemoj tako, Dule...
Nemoj tako, Dule...	Žene. Jebo ih onaj ko ih izmisli.
Žene. Jebo ih onaj ko ih izmisli.	U kupatilu... Boli je stomak.
U kupatilu... Boli je stomak.	Gde je Kaća?
Pa jest. I onda sam se oženio. Posle kad je rekla za bebu, bilo mi jesvejedno... Sad bar imamo gde, imamo stan i pristojnu lovu.	Divlji brak, ta šema...?
Divlji brak, ta šema...?	Htela je stan. I kola. Znaš šta, Dule, nisam ja baš tako hteo... odmah sve,      ženidba, dete... Hteo sam prvo malo da živimo, da probamo... Njeni su insistirali.
Htela je stan. I kola. Znaš šta, Dule, nisam ja baš tako hteo... odmah sve,      ženidba, dete... Hteo sam prvo malo da živimo, da probamo... Njeni su insistirali.	Jeste, ali imala je ı u Beogradu. Samo, tamo ti nisi imao šta da joj ponudiš.
Jeste, ali imala je ı u Beogradu. Samo, tamo ti nisi imao šta da joj ponudiš.	Zato Sanja ima puno slobodnog vremena.
Zato Sanja ima puno slobodnog vremena.	...da ćeš da se raduješ svakoj slobodnoj nedelji, koje su, doduše, u početku   bile retke, ali i to je bolje, jer kad radi§ non-stop, nemaš kad ni da trošiš lovu...
...da ćeš da se raduješ svakoj slobodnoj nedelji, koje su, doduše, u početku   bile retke, ali i to je bolje, jer kad radi§ non-stop, nemaš kad ni da trošiš lovu...	Pa to sa agencijom mi baš nije padalo na pamet...
Pa to sa agencijom mi baš nije padalo na pamet...	Pa to ti ı kažem. Je l' si se nadao da će tako brzo da prođe. Da ćeš za godinu dana da postaneš muž, otac, hranilac porodice, službenik ugledne sidneJ-ske turističke agencije...
U svakom slučaju, Kaća je bila zapela da se ženimo i da se iselimo. Daidemo u Australiju. Kaze, ovde je perspektiva. I ja je oženim, prodam vartburga, ploče i zvučnike, pa na put. Čim smoseli u avion, baba umre. Keva kaže od tuge.	Ma, gde moze... U stvari, ne znam. Nismo to učili.
Ma, gde moze... U stvari, ne znam. Nismo to učili.	To sam joj i ja rekao. Onda je ona rekla da sam edipovac. E, aj’ majke ti,ti si to imao na faksu, je l’ moze éovek da ima Edipov kompleks prema babi?
To sam joj i ja rekao. Onda je ona rekla da sam edipovac. E, aj’ majke ti,ti si to imao na faksu, je l’ moze éovek da ima Edipov kompleks prema babi?	Odvratno... Kako baba može da... mislim, stara je.
Odvratno... Kako baba može da... mislim, stara je.	Otkud znam, Kaća kaže, da bi drkala.
Otkud znam, Kaća kaže, da bi drkala.	Što bi vas baba slušala?
Što bi vas baba slušala?	Kaže da nas je slušala. Da je tačno znala kad ćemo da se karamo, pa seonda primiri i sluša...
Kaže da nas je slušala. Da je tačno znala kad ćemo da se karamo, pa seonda primiri i sluša...	Kako, majke ti...?
Kako, majke ti...?	Ja sam im'o stan, onaj babin, na Zvezdari. Al' im'o sam i babu. Kaća kaže da ju je to seksualno osakatilo, da je baba ubila njen libido...
Pa, to stomak... nemam pojma, nešto joj fali.	Ja sam mislio da je stomak.
Ja sam mislio da je stomak.	U kupatilu. Boli je glava.
U kupatilu. Boli je glava.	Šta si rekao, gde je Kaća?
Ne mogu ja da se napijem, Miloše. Od kako sam došao ovde, od kakosam doputovao, od one prve noći, kada sam ležao budan u hotelu, kada samgledao u cevi radijatora, u bubašvabe koje idu pravilnim redom, u koloni, sklanjajući se da propuste jedna drugu, od kako sam ih brojao i njih i ovce i stadakengura, ne bih li barem malo odspavao, od tada, ja vise nikada ne mogu dase napijem, Miloše. Jednostavno, nije mi ništa. Nikakve senzacija, nikakva emocija, ništa... A znaš zašto? Zato što sam se tada, te noći, u tom šugavom hotelu, dokje moja žena mirno spavala pored mene, omamljena dugim letom i džet legom,zato što sam se usr'o od straha. Straha od onoga što me čeka. Od života daleko od kuće. Od života s mojom ženom. Od života, Miloše.	Koj ti je, bre, Dule, vidiš da si se ipak napio!!!
Koj ti je, bre, Dule, vidiš da si se ipak napio!!!	Je l' to znači da među nama nema tajne?
Je l' to znači da među nama nema tajne?	Jesmo.
Jesmo.	Reci mi, jesmo li najbolji prijatelji?
Reci mi, jesmo li najbolji prijatelji?	Šta te je sad spopalo, šta me pitaš to...?
Šta te je sad spopalo, šta me pitaš to...?	A jesmo najbolji prijatelji?
A jesmo najbolji prijatelji?	Jesmo, Dule. Prijatelji smo.
Jesmo, Dule. Prijatelji smo.	Aha... Je li, Miloše, jesmo li mi prijatelji?
Ja ću da isečem.	Ohladiće se meso.
Nema problema...	Kaća, da mi pomogneš da začinim salatu.
Nije kesa. Al' nije ni super. U stvari, nemam pojma. Onako, normalnoje. Obično.	Je li? Ja sam uvek mislila, Holivud, to mora je nešto opasno. Ono, filmovi, glumci, šou biz, te fore. Kad - kesa.
Je li? Ja sam uvek mislila, Holivud, to mora je nešto opasno. Ono, filmovi, glumci, šou biz, te fore. Kad - kesa.	Zvuči dobro, al' i nije neki kraj. Od komšija, gajim samo Meksose.
Zvuči dobro, al' i nije neki kraj. Od komšija, gajim samo Meksose.	Što to dobro zvuči. A man from Hollywood.
Što to dobro zvuči. A man from Hollywood.	Ja sam odavde. Mislim, i ja sam iz Beograda, ali sad živim ovde. U Holivudu.
Ja sam odavde. Mislim, i ja sam iz Beograda, ali sad živim ovde. U Holivudu.	Iz Njujorka. U stvari, iz Beograda. Ali sad živim u Njujorku. A ti?
Iz Njujorka. U stvari, iz Beograda. Ali sad živim u Njujorku. A ti?	Trudim se. Odakle si?
Trudim se. Odakle si?	A ti si neki pristojan tip?
A ti si neki pristojan tip?	Otkud znam. Računam, u Americi je pristojno da pričam američki.
Otkud znam. Računam, u Americi je pristojno da pričam američki.	Pa što nisi rekao!?
Pa što nisi rekao!?	Izgleda.
Izgleda.	Jovan? Sereš. Pa ti si naš?
To ti i ja kažem, neko je taj užas spakovao i doneo čak ovde... E da miJe da vidim taj mozak...	Ma to je neko doneo.
Sta je smešno, kaži! Kaži mi, molim te, šta je smešno! E, keve ti, reci mi šta je smešno...	A ti misliš na žur!!! A ja mislio...
A ti misliš na žur!!! A ja mislio...	Kako to misliš, ne kapiraš?
Kako to misliš, ne kapiraš?	Ne kapiram.
Ne kapiram.	Kaže, da dočekam prvu Novu godinu na plaži.
Kaže, da dočekam prvu Novu godinu na plaži.	Molim?
Molim?	Pa, kažem ti, zvala me drugarica na doček...
Pa, kažem ti, zvala me drugarica na doček...	Pa što si onda ovde?
Pa što si onda ovde?	Nemam pojma.
Nemam pojma.	Je l' se tebi sviđa?
Je l' se tebi sviđa?	I, je l' ti se sviđa?
I, je l' ti se sviđa?	Pa to ı nije tako mnogo. Ja sam ovde tri godine.
Pa to ı nije tako mnogo. Ja sam ovde tri godine.	Aha. Tamo sam već šest meseci.
Aha. Tamo sam već šest meseci.	Ma ja znam ove ljude. Ne znam samo kad su se tako izdžiberisali. I znači, dolaziš iz Njujorka?
Ma ja znam ove ljude. Ne znam samo kad su se tako izdžiberisali. I znači, dolaziš iz Njujorka?	E, je l' znaš da kapiram, ovako, kad zatvorim oči, kapiram da sam nasplavu. U bloku četrespet. Nije da sam nekad bila, al' sto posto je isto ovako!
E, je l' znaš da kapiram, ovako, kad zatvorim oči, kapiram da sam nasplavu. U bloku četrespet. Nije da sam nekad bila, al' sto posto je isto ovako!	Odličan potez. Ovakav žur nisi smela da propustiš!
Odličan potez. Ovakav žur nisi smela da propustiš!	Došla sam kod drugarice, za božićne praznike.
Došla sam kod drugarice, za božićne praznike.	Kad ti kažem. Nije bila jača, al' je bila bolja. Onako, smešnija. A, otkudti ovde?
Kad ti kažem. Nije bila jača, al' je bila bolja. Onako, smešnija. A, otkudti ovde?	Ih, sad.
Ih, sad.	Samo, znaš šta, kad sam letovao na Visu, u Komiži, veruj mi, na terasisam u saksiji gajio bolju vutru od ove.
To nikad nisam čuo... a i ne vidim ništa. Koza ti je divna.	Tu. I tu... Ma, svuda!
Tu. I tu... Ma, svuda!	Ozbiljno? Pa gde ti izlaze?
Šta ti izlazi?	Izlaze mi bubuljice.
Izlaze mi bubuljice.	Ma nemoj, a što?
Ma nemoj, a što?	E, znaš šta, nije da ja nešto duvam, u stvari i ne duvam uopšte.
E, znaš šta, nije da ja nešto duvam, u stvari i ne duvam uopšte.	Nisam rek'o da je loša, nego da znam i za bolju.
Nisam rek'o da je loša, nego da znam i za bolju.	Loša trava, a?
Loša trava, a?	E, kakva fora...
E, znaš šta, nisam ja glupa!	Ma jok...
Ma jok...	Nemam pojma, ti si rek'o... zbunila sam se! Ti sto posto misliš da sam ja neka kokoška.
Nemam pojma, ti si rek'o... zbunila sam se! Ti sto posto misliš da sam ja neka kokoška.	Pa što se onda okrećeš?
Pa što se onda okrećeš?	A to... Nisam sa dečkom, sama sam. U stvari, i nemam dečka.
A to... Nisam sa dečkom, sama sam. U stvari, i nemam dečka.	Nemam pojma, ja pitam.
Nemam pojma, ja pitam.	Gde?
Gde?	Ovde ti je dečko?
Valjda ima.	Pa je l' ima?
Pa je l' ima?	Šutn'o me je. Raskinuli smo kad sam kretala. Kaže, Amerika ga ne zanima. Ima onsvoje ime u Beogradu, svoj posao, prijatelje...
Šutn'o me je. Raskinuli smo kad sam kretala. Kaže, Amerika ga ne zanima. Ima onsvoje ime u Beogradu, svoj posao, prijatelje...	Izvini, molim te!!!
Izvini, molim te!!!	Šta te boli dupe!
Šta te boli dupe!	Pa to. Kako to da nemaš dečka?
Pa to. Kako to da nemaš dečka?	Šta pa?
Šta pa?	Pa?
Pa?	Ništa.
Ništa.	Izvini.
Izvini.	Ne seri.
Ne seri.	Otkud to? Mislim, dobra si riba... 'Oću reći, interesantna si, ovako zanimljiva...
Otkud to? Mislim, dobra si riba... 'Oću reći, interesantna si, ovako zanimljiva...	Ccc.
Ccc.	Znači, nemaš dečka?
Sereš!	Ja sam pijanistkinja.
Ja sam pijanistkinja.	A ti? Šta ti radiš?
Ma nemoj, baš me čudi...	Nema veze, ta neka riba dolazi, ı ja kao čuka mi nešto kao ne radi, nešto udara, čuje se ono u ofu, tdk-tdm, tdk-tdnm tdj-tdm i ja kao stanem, oname pogleda, pruži tabletu i kaže „Dečko, 'ajde oladi!“.. I onda natpis, ime tih tableta. Ne znaš, sigurno. A i nije se puno emitovala...
Nema veze, ta neka riba dolazi, ı ja kao čuka mi nešto kao ne radi, nešto udara, čuje se ono u ofu, tdk-tdm, tdk-tdnm tdj-tdm i ja kao stanem, oname pogleda, pruži tabletu i kaže „Dečko, 'ajde oladi!“.. I onda natpis, ime tih tableta. Ne znaš, sigurno. A i nije se puno emitovala...	Aha...
Aha...	Ma znaš, ona reklama, kao ja dolazim, a jedna riba meni ide u susret,kao riba opasna, ona mala Jelena, znaš ona manekenka, što se zabavlja saonim, vlasnikom „Zvezde“..
Ma znaš, ona reklama, kao ja dolazim, a jedna riba meni ide u susret,kao riba opasna, ona mala Jelena, znaš ona manekenka, što se zabavlja saonim, vlasnikom „Zvezde“..	Za srce...?
Za srce...?	Ma jok. U stvari, možda jesi. Je l’ znaš onu reklamu, ono za tablete za... ono, neka fora za srce, na bazi belog luka...
Ma jok. U stvari, možda jesi. Je l’ znaš onu reklamu, ono za tablete za... ono, neka fora za srce, na bazi belog luka...	Aha. U junu sam diplomirala. I šta kazeš, glumac? Pa je l' sam te gledala negde?
Aha. U junu sam diplomirala. I šta kazeš, glumac? Pa je l' sam te gledala negde?	Ja sam glumac. Ne serem, ozbiljno! Diplomirao sam na FDU. I ti si s Akademije?
Ja sam glumac. Ne serem, ozbiljno! Diplomirao sam na FDU. I ti si s Akademije?	Ozbiljno. A ti?
E, Jovane, ne moraš ti meni da kažeš, mislim, nema veze, ja se tebi jesam poverila za dečka, al' ti meni ne moraš ništa da pričaš...	Ja stvarno ne znam o čemu ti govoriš...?
Ja stvarno ne znam o čemu ti govoriš...?	Izbegavaš, izbegavaš! A što?
Izbegavaš, izbegavaš! A što?	Koje pitanje?
Koje pitanje?	Je li, je l’ ti to izbegavaš pitanje?
Je li, je l’ ti to izbegavaš pitanje?	'Oćeš?
'Oćeš?	Da mi pozajmi klavir? Ti si stvarno nenormalan. A šta je bilo s pozorištem?
Da mi pozajmi klavir? Ti si stvarno nenormalan. A šta je bilo s pozorištem?	Pa što ti ne pozajmi?
Pa što ti ne pozajmi?	Znam.
Znam.	Pa zar ne znaš nekog ko ima?
Pa zar ne znaš nekog ko ima?	Nemam klavir. A pozorište?
Nemam klavir. A pozorište?	A sad, ne vezbas više?
A sad, ne vezbas više?	Majke mi. Ja sam redovan pratilac školskog programa. Obično, kad vežbam, mislim, ranije, dok sam vežbala, ja uključim teve, ali bez tona, na mutavo, pa sviram i gledam slike. Volim tako nešto da mi se mrda. I onda, običnoujutru vežbam, mislim vežbala sam, ranije... A pozorište?
Majke mi. Ja sam redovan pratilac školskog programa. Obično, kad vežbam, mislim, ranije, dok sam vežbala, ja uključim teve, ali bez tona, na mutavo, pa sviram i gledam slike. Volim tako nešto da mi se mrda. I onda, običnoujutru vežbam, mislim vežbala sam, ranije... A pozorište?	Sereš.
Sereš.	E, to sam sto posto gledala.
E, to sam sto posto gledala.	E, igrao sam ja u školskom programu. Hemija za sedmi i osmi razred.
I?!	I ništa, igrali smo jedno pet-šest predstava po Srbiji, preko jednog ortaka smo organizovali šemu sa domovima kulture...
I ništa, igrali smo jedno pet-šest predstava po Srbiji, preko jednog ortaka smo organizovali šemu sa domovima kulture...	I?
I?	Nema tu šta da se priča. Igrao sam u jednom komadu. Nešto studentski, bezveze. Nas nekoliko, s klase. Spremali smo Držića za ispit, pa nam je bilo zgodno da putujemo malo po unutrašnjosti, da uzmemo heku kintu. Mislilismo, narod voli takve komade, ima tu i psovki i seksa i onako, veselo je...
Ništa. Spakovao kofere ı došao ovde. Puk'o mi film. Nemoj pogrešnoda me razumeš, zabole mene ı za tu profesorku, i za tog malog u nekoj vukojebini, koju nisam ni znao da nađem na karti, nego ovako... Sve mi se smučilo. Bilo me sramota. Sramota od svojih...	Pa i nije... I Sta si ti onda uradio?
Pa i nije... I Sta si ti onda uradio?	Nije. Kaže, niste baš morali hrvatsku literaturu. Nije zgodno, deca surazdražljiva. Mrze Hrvate, morate da ih razumete... Ej! Kapiraš, profesorka gimnazije, to mi prijavljuje! Da moram da razumem što maloletnici hoće da melinčuju, jebi ga, nacionalizam nije zakonom zabranjen.
Nije. Kaže, niste baš morali hrvatsku literaturu. Nije zgodno, deca surazdražljiva. Mrze Hrvate, morate da ih razumete... Ej! Kapiraš, profesorka gimnazije, to mi prijavljuje! Da moram da razumem što maloletnici hoće da melinčuju, jebi ga, nacionalizam nije zakonom zabranjen.	Pa zar nije?
Pa zar nije?	Ništa, kad se sve smirilo, mi odemo kod te profesorke da razgovaramo,nemam pojma, mislili smo da će da nam se izvini...
Ništa, kad se sve smirilo, mi odemo kod te profesorke da razgovaramo,nemam pojma, mislili smo da će da nam se izvini...	Au... I šta je bilo posle.
Au... I šta je bilo posle.	"Majke mi. I mi sad već stanemo, ne moze da se igra od njega. Dere se,kaze, ,Sad ću da vam jebem mater, samo da se popnem gore...""  Mi nećemo dase nadvikujemo, čekamo da neko nešto uradi. Nastane graja, on krene kao dase uzvlači iz reda, kreće ka pozornici, znaš šta i nije baš da je mali, onako krupan dečko, ovolike šake...  I mi tu vidimo da niko ništa ne preduzima. Ja pogledom pronađem neku profesorku, predaje srpski, s njom smo sve i dogovorili,ona gleda u pod. Ovaj moj ortak počne da viče: „Kome ti psuješ mater.""  Ovajodgovara: „Tebi, ustašo!“, ja vidim, biće tuče, mahnem tetkicama gore da spuste zavesu i one spuste."
"Majke mi. I mi sad već stanemo, ne moze da se igra od njega. Dere se,kaze, ,Sad ću da vam jebem mater, samo da se popnem gore...""  Mi nećemo dase nadvikujemo, čekamo da neko nešto uradi. Nastane graja, on krene kao dase uzvlači iz reda, kreće ka pozornici, znaš šta i nije baš da je mali, onako krupan dečko, ovolike šake...  I mi tu vidimo da niko ništa ne preduzima. Ja pogledom pronađem neku profesorku, predaje srpski, s njom smo sve i dogovorili,ona gleda u pod. Ovaj moj ortak počne da viče: „Kome ti psuješ mater.""  Ovajodgovara: „Tebi, ustašo!“, ja vidim, biće tuče, mahnem tetkicama gore da spuste zavesu i one spuste."	Ma daj...
Ma daj...	"Ma kakvi. Malo se to razdr’o, sala se zasmejala, mi, kao, nema veze, nismo ništa čuli, nastavimo da igramo, kad mali ustane. Kaze: „Čuješ ti šta ti jakažem, pička ti materina hrvatska! Ovde si našo da mi se pederišeš!!!"""
"Ma kakvi. Malo se to razdr’o, sala se zasmejala, mi, kao, nema veze, nismo ništa čuli, nastavimo da igramo, kad mali ustane. Kaze: „Čuješ ti šta ti jakažem, pička ti materina hrvatska! Ovde si našo da mi se pederišeš!!!"""	Pa, zar nisu?
Pa, zar nisu?	Znam, to smo i mi mislili, i nama je prvo bilo smešno. Meni čak i biložao klinca, kapirao sam, sad će da ga uhvate profesori, pa da vode kod direktora...
Znam, to smo i mi mislili, i nama je prvo bilo smešno. Meni čak i biložao klinca, kapirao sam, sad će da ga uhvate profesori, pa da vode kod direktora...	Izvini, toliko je glupo da moram da se smejem.
Izvini, toliko je glupo da moram da se smejem.	"I mi tu krenuli prestavu, Dundo Maroje i sad izade taj moj ortak, on jeigrao Petrunjelu, pošto smo hteli tako, tu originalnu foru da zadrzimo, da muškarci igraju žene, a i ova devojka s klase nije htela da putuje, nije bitno sad, iizađe on, krene da igra, kad ono iz publike, jedan se digne i zaurla: ,Vidi ga peder, mamu mu jebem, hrvatsku!"" Pa, jeste, smešno je..."
"I mi tu krenuli prestavu, Dundo Maroje i sad izade taj moj ortak, on jeigrao Petrunjelu, pošto smo hteli tako, tu originalnu foru da zadrzimo, da muškarci igraju žene, a i ova devojka s klase nije htela da putuje, nije bitno sad, iizađe on, krene da igra, kad ono iz publike, jedan se digne i zaurla: ,Vidi ga peder, mamu mu jebem, hrvatsku!"" Pa, jeste, smešno je..."	Kapiram, kapiram, i?
Kapiram, kapiram, i?	I onda smo došli u neku selendru, ne znam ni kako se zvala. U svecanu salu gimnazije. Puna sala i dece i profesora. Nisu to, u stvari, uopšte deca,to su već gimnazijalci, tinejdžeri...
Pa, u stvari, ništa.	Šta gluma?
Šta gluma?	Aha... A gluma?
Aha... A gluma?	Muving. Selim ljude, nosim stvari, razvozim.
Muving. Selim ljude, nosim stvari, razvozim.	Šta radiš po kućama?
Šta radiš po kućama?	Po kuéama.
Po kuéama.	Gde?
Gde?	Radim.
Radim.	Pa je l' radiš?
Pa je l' radiš?	Aha. Holivud.
Aha. Holivud.	Znam. A ipak, ovde ti je bitno da budeš, zbog posla. Holivud i to...
Znam. A ipak, ovde ti je bitno da budeš, zbog posla. Holivud i to...	Nisam. Imao sam turističku vizu, na šest meseci. Kad je isticala, ja samodlučio da ipak ostanem. Sad ne mogu napolje. Mislim mogu, ali onda ti nešto lupe u pasoš i ne možeš više nikad da uđeš u Ameriku.
Nisam. Imao sam turističku vizu, na šest meseci. Kad je isticala, ja samodlučio da ipak ostanem. Sad ne mogu napolje. Mislim mogu, ali onda ti nešto lupe u pasoš i ne možeš više nikad da uđeš u Ameriku.	Ni ja. I, je I’ si se vraćao u Beograd od tada?
Ni ja. I, je I’ si se vraćao u Beograd od tada?	Ne mogu.
Ne mogu.	Hoćeš da duvaš?
Nju jok. Čuti, bolje joj je ovako. Udala, se radi na teveu. Čita vesti i vo-   di top listu. Keva mi kaže da sad i čeka bebu...  sve za šest meseci.	A nju?
A nju?	Majke mi. Ima ta neka državna lutrija, svake godine. Prijavila me drugarica, onako, bezveze, i mene izvuku.
Majke mi. Ima ta neka državna lutrija, svake godine. Prijavila me drugarica, onako, bezveze, i mene izvuku.	Ma daj, stvarno?
Ma daj, stvarno?	U Ameriku? Nećeš verovati. Dobila sam grin kard na lutriji.
U Ameriku? Nećeš verovati. Dobila sam grin kard na lutriji.	Čekaj, pa što si uopšte došla?
Čekaj, pa što si uopšte došla?	Nešto. Nešto mora da se dogodi.
Nešto. Nešto mora da se dogodi.	A šta?
A šta?	Ništa. Čekaću.
Ništa. Čekaću.	A klavir? Pa, šta ćeš?
A klavir? Pa, šta ćeš?	Služim.
Služim.	Sviraš?
Sviraš?	U jednoj kafani.
U jednoj kafani.	A ti? Radiš? Gde?
A ti? Radiš? Gde?	Pa, u stvari ništa.
Pa, u stvari ništa.	A ti? Radiš?
Ovo je sad moja kuća.	Možeš i ti.
Možeš i ti.	Ti barem možeš da se vratiš kući.
Ti barem možeš da se vratiš kući.	Otkud znam. Može da bude. A ne mora. Treba samo da čekam.
Otkud znam. Može da bude. A ne mora. Treba samo da čekam.	Pa je l' bolje?
Pa je l' bolje?	Pa posle ceo život da se jedem što nisam ni probala. Kako noću da spavam,a da znam da sam propustila priliku za život kakav nikada ne bih mogla da imamu Beogradu, da sam jednostavno odbila čak i da probam! Da sam bila kukavica, čaki da vidim kako je živeti negde gde je bolje! Gde bi trebalo da je bolje...
Pa posle ceo život da se jedem što nisam ni probala. Kako noću da spavam,a da znam da sam propustila priliku za život kakav nikada ne bih mogla da imamu Beogradu, da sam jednostavno odbila čak i da probam! Da sam bila kukavica, čaki da vidim kako je živeti negde gde je bolje! Gde bi trebalo da je bolje...	Ti si morala to da iskoristiš.
Ti si morala to da iskoristiš.	Nemam pojma. Ne razgovaramo. Šta je, šta me gledaš tako! Ne razgovaramo, jer ja neću! Ma neću više da je vidim! Ko je, bre, ona, ko njoj daje za pravo da diktira moj život, da mi utiče na sudbinu! S kojim pravom me je stavila pred ovoiskušenje, s kojim? Imam papire, okej, to je lepo, ali nisam ja tako planirala!!!
Nemam pojma. Ne razgovaramo. Šta je, šta me gledaš tako! Ne razgovaramo, jer ja neću! Ma neću više da je vidim! Ko je, bre, ona, ko njoj daje za pravo da diktira moj život, da mi utiče na sudbinu! S kojim pravom me je stavila pred ovoiskušenje, s kojim? Imam papire, okej, to je lepo, ali nisam ja tako planirala!!!	Baš lepo. Pa, je I' zadovoljna?
Baš lepo. Pa, je I' zadovoljna?	Ona je meni učinila i sad joj se vraća.
Ni ja.	Nemam pojma, ne nosim sat.
Nemam pojma, ne nosim sat.	Koliko je sati? Nemoj da nam prođe ponoć.
Pa, ako je takva situacija, šta ću, ne mogu da se protivim...	Mora prvo da se kresnemo. Da vidimo, da l’ se slazemo, da l’ odgovaramo jedno drugom... Ne mozemo ovako, grlom u jagode!
Mora prvo da se kresnemo. Da vidimo, da l’ se slazemo, da l’ odgovaramo jedno drugom... Ne mozemo ovako, grlom u jagode!	Zašto?
Zašto?	A znaš zašto?
A znaš zašto?	Znao sam.
Znao sam.	Ne može.
Ne može.	E, a kako bi bilo da se mi venčamo, mislim, prvo ti da se zaljubiš u mene, pa onda da se venčamo i onda ja kao tvoj muz dobijem sredene sve papire i dozvolu za rad, i onda živimo ovde i bude nam super. A, šta misliš?
Budalo.	Je l' ovaj to tebi?
Ma ne...	Je li, je l’ bi to neko da se kadi s Dačom?
Kažem...	Šta si rek'o?
Šta si rek'o?	Nemam pojma. Idi pitaj Daču.
Je li, dečko, 'očeš da mi objasniš, ša je smešno.	Ma jok...!!!
Ma jok...!!!	Je li, je l’ to Daču neko zajebava?
Dobro, kad nećeš... Kako se zoveš?	Da se drogiram? Pa ja sam, bre, fin momak!
Da se drogiram? Pa ja sam, bre, fin momak!	Ma ništa, izvini. Malo smo duvali. Hoćeš i ti malo?
A, da, Dača.	Rek'o ti je čovek, nekoliko puta.
Iz Tusona.	Pa, sedi malo, Dačo. Odakle si?
Tuson, bre, Arizona!	Odakle?
Čekaj, Dačo, smiri se. Nismo mislili ništa loše.	Sta je bilo, narkomani, u čemu je problem? 'Oće neko se futi, ša...!?!
E sad ću da te polomim ko pičku.	Laže, Dačo, mislili smo.
Pre tri dana.	Znači, živiš u Arizoni. Kad si došao...?
Znači, živiš u Arizoni. Kad si došao...?	Aha. Aha.
Aha. Aha.	Šta ga izazivaš! E, pa dobro, drago mi je da smo se upoznali...
Šta ga izazivaš! E, pa dobro, drago mi je da smo se upoznali...	Ko?
Ko?	Ma čuo si, sto posto. To su ti Bitlsi.
Ma čuo si, sto posto. To su ti Bitlsi.	Nikad čuo.
Nikad čuo.	Pa to, Džo-Džo je kao otišao od kuće, znaš...
Pa to, Džo-Džo je kao otišao od kuće, znaš...	Kako?
Kako?	Ćuti, Jovane! Nije Dačo, majke mi. Nego ima ta pesma, ono ,Jo-jo lefthis home, from Tucson, Arizona“, znaš...
Kupio mi ćale kadilak za rodžendan. Pa me poslo u El Ej kod tetke, daprobam mašinu.	Kakvim kolima?
Kakvim kolima?	Kakav let? Došo sam kolima.
Kakav let? Došo sam kolima.	Znam, ali, toliki let...
Znam, ali, toliki let...	Šo da mi je naporno? Nije Dača sisa.
Šo da mi je naporno? Nije Dača sisa.	Samo pet dana? Toliki put za pet dana. To je malo naporno?
Samo pet dana? Toliki put za pet dana. To je malo naporno?	Sutra se vraćam.
Sutra se vraćam.	I, koliko ostaješ?
A...	Pa, u Tusonu, kretenu. Tuson, Arizona, je l' ti lepo žeka. Ćale mi se doselio ovde pre dvadeset godina. Ovde mi je i snuokre kevu, pa sam se, logično,tu i rodio. Kažem ti da sam došao u El EJ, kod tetke.
Pa, u Tusonu, kretenu. Tuson, Arizona, je l' ti lepo žeka. Ćale mi se doselio ovde pre dvadeset godina. Ovde mi je i snuokre kevu, pa sam se, logično,tu i rodio. Kažem ti da sam došao u El EJ, kod tetke.	Gde?
Gde?	Ša kenjaš, bre, dalobu? Kakav dolazak, ja sam ovde rođen!
Ša kenjaš, bre, dalobu? Kakav dolazak, ja sam ovde rođen!	E, izvini, molim te, al' ja stvarno ne razumem. Kako si mogao u Ameriku da dođeš kolima?
E, izvini, molim te, al' ja stvarno ne razumem. Kako si mogao u Ameriku da dođeš kolima?	Ša je bilo, brate? Ša ti nije jasno!?
Imaš i šta. Osamnes, bajo punoletstvo. Malo li je?	E pa čestitam.
E pa čestitam.	Osamnaesti.
Osamnaesti.	A... A koji?
A... A koji?	Pa, je l' ti kažem da mi je rodžendan.
Pa, je l' ti kažem da mi je rodžendan.	A, izvini, vidim da si veseo...
A, izvini, vidim da si veseo...	Kakvu bre novu godinu. To je ova, katolička, mamu mu jebem ustašku. Ja slavim samo srpsku...
Kakvu bre novu godinu. To je ova, katolička, mamu mu jebem ustašku. Ja slavim samo srpsku...	Za Novu godinu, pa da.
Slušaj, barabo, ja mislim da sam ti ja lepo rekao!	Aha. Pa i pička nije neka lepotica.
Aha. Pa i pička nije neka lepotica.	Zato što je to ružno.
Zato što je to ružno.	Dobro kad kažeš... A šo?
Dobro kad kažeš... A šo?	Jeste.
Jeste.	Je li?
Je li?	Čekaj, Maro, slušaj dečko, ovo ovde je moja devojka i molim te, nemojda je nazivaš imenima polnih organa.
E, onda si najeb'o.	Ma nemoj. Šta onda?
Ma nemoj. Šta onda?	A ako nemaš nameru da jebeš, nego ti smeta moje društvo, onda, brate, neće biti dobro...
A kod biblioteke, je li...?	Kod Narodne biblioteke...
S Neimara.	Iz kog kraja?
Iz kog kraja?	Iz Beograda.
Iz Beograda.	Odakle si?
„Bori se ko muškarac! E pederu narkomanski, sad ču da ti jebem pičku!!!	Ostavi je, kad ti kažem! Bori se kao muškarac!!!
Ostavi je, kad ti kažem! Bori se kao muškarac!!!	Ša je bilo, pederčiću. Ima’ neki problem?
